# # # # # # # # # # # # # # # # # # # # # # # # # # # # # # # # # # # # # # # # # 
#                           #   #       #   #               #   #               # 
# # # # #   #   # # # # #   #   #   # # #   #   # # #   # # #   # # #   # # # # # 
#   #   #   #           #   #           #       #           #   #           #   # 
#   #   # # # # #   # # # # #   # # # # # # # # # # #   # # #   # # # # #   #   # 
#   #       #       #       #   #   #   #       #   #       #   #               # 
#   #   # # # # #   #   # # #   #   #   # # #   #   #   # # #   # # #   # # # # # 
#   #   #   #   #       #           #       #   #   #   #   #       #       #   # 
#   #   #   #   # # #   #   # # #   #   # # #   #   #   #   #   # # #   #   #   # 
#                       #   #   #           #   #                       #       # 
#   #   # # #   #   # # # # #   # # #   # # #   #   # # # # #   #   #   # # #   # 
#   #       #   #   #           #       #               #       #   #       #   # 
# # #   # # # # #   # # #   #   # # #   # # #   # # #   # # #   #   # # # # # # # 
#   #   #               #   #   #           #       #   #       #               # 
#   #   # # # # #   # # # # #   # # #   # # #   # # # # #   # # # # #   # # # # # 
#       #       #                                       #       #   #   #       # 
# # # # # # #   # # # # #   # # # # #   #   # # # # #   # # # # #   # # # # #   # 
#       #               #   #           #       #   #   #   #                   # 
# # #   # # # # #   # # # # # # # # #   # # # # #   # # #   #   # # #   #   # # # 
#               #   #                   #                           #   #       # 
# # # # #   #   #   # # # # # # # # #   # # #   # # # # #   #   #   #   # # #   # 
#   #       #   #               #                       #   #   #   #   #   #   # 
#   # # # # #   # # #   #   #   # # #   #   #   # # #   # # #   # # # # #   # # # 
#                       #   #           #   #       #   #                       # 
# # # # # # # # # # # # # # # # # # # # # # # # # # # # # # # # # # # # # # # # # 
